
C 225,225,000
F 255,100,0

SO ./texture/north.xpm

NO ./texture/sky.xpm



WE ./texture/fuckin.xpm
EA ./texture/sky.xpm










11111111111111111111111111
1N00010000000001
11101011111011111111111
100010001000101
101111111011101
101000001010001
101011101010111
100010100000101
111110111111101
100000000000001
111111111111111
