NO ./texture/solid_blue.xpm
SO ./texture/solid_green.xpm
WE ./texture/solid_yellow.xpm
EA ./texture/sky.xpm
C 225,30,0
F 220,100,0
11110111
1S000111
111111111
