NO ./texture/solid_blue.xpm
SO ./texture/solid_green.xpm
WE ./texture/solid_yellow.xpm
EA ./texture/broken.xpm
C 225,30,0
F 220,100,0
11111
1N001
10001
11111
