NO ./texture/solid_blue.xpm
SO ./texture/solid_green.xpm
WE ./texture/solid_yellow.xpm
EA ./texture/sky.xpm
C 225,30,0
F 220,100,0
1111111
100001
1000N0001
1000001
1111111
