NO ./texture/solid_blue.xpm
SO ./texture/solid_green.xpm
WE ./texture/solid_yellow.xpm
EA ./texture/sky.xpm
C 225,30,0
F 220,100,0
1111111
1 0  01
1000N01
1000001
1111111
