NO ./texture/north.xpm
SO ./texture/south.xpm
WE ./texture/west.xpm
EA ./texture/east.xpm
C 225,30,0
F 220,100,      0
1111111111111111111
1000000100000100001
1011101110111011101
1000100010001000101
1110101110101110101
1000101000100010001
1011101011111011101
100N001000001000001
1110111011101110111
1000100000000000101
1011101110001111101
1000001000001000001
1011101011111011101
1000101000100010001
1110101110101110101
1000100010001000101
1011101110111011101
1000000100000100001
1111111111111111111
