NO ./texture/north.xpm
SO ./texture/south.xpm
WE ./texture/west.xpm
EA ./texture/east.xpm
C 225,30,0
F 20,10,10
1111111111111111111
1E00000000000000001
1000010000100001001
1000000000000000001
1000100010001000101
1000000000000000001
1000001000100010001
1000000000000000001
1001000000000000101
1000000000000000001
1000010000100001001
1000000000000000001
1000100010001000101
1000000000000000001
1000001000100010001
1000000000000000001
1111111111111111111
