NO ./texture/north.xpm
SO ./texture/south.xpm
WE ./texture/west.xpm
EA ./texture/east.xpm
C 5,0,20
F 100,70,100
1111111111111111111111111
1000000E00110000000000001
1011000001110000000000001
100100000000000000000000111111111
111111111011000001110000000000001
100000000011000001110111111111111
11110111111111011100000010001
11110111111111011101010010001
11000000110101011100000010001
10000000000000001100000010001
1000000000000001101010011011
1100000111101011111011110011
11110111 1010101 101111011001
11111111 1111111 111111111111