NO ./texture/fuckin.xpm
SO ./texture/fuckin.xpm
WE ./texture/fuckin.xpm
EA ./texture/fuckin.xpm
C 225,30,0
F 220,100,0
1111111 1
   1W011111111
111111