NO ./texture/fuckin.xpm
SO ./texture/fuckin.xpm
WE ./texture/fuckin.xpm
EA ./texture/fuckin.xpm
C 225,30,0
F 220,100,0
 111111111111111111111111111111111111
1111000000000000000000000000000000001
   101E01011010010101010101001010101
    1 11 1  1 11 1 1 1 1 1 11 1 1 1  