NO ./texture/solid_blue.xpm
SO ./texture/solid_green.xpm
WE ./texture/solid_yellow.xpm
EA ./texture/sky.xpm
C 225,30,0
F 220,100,0
111111111
100000001
100010001
1000E0001
100010001
100000001
111111111
