NO ./texture/north.xpm
SO ./texture/south.xpm
WE ./texture/west.xpm
EA ./texture/east.xpm
C 100,100,100
F 50,50,50
1111111111111111111111
1000000000000000000001
1010101010101010101001
1010101010101010101001
1010101010101010101001
1000000000000000000001
1010101010101N1010101
1010101010101010101001
1000000000000000000001
1111111111111111111111
