NO ./texture/solid_blue.xpm
EA ./texture/sky.xpm
WE ./texture/solid_yellow.xpm
SO ./texture/solid_green.xpm
C 225,30,0
F 220,100,0
11111111111111111111
10000011000001000001
10000011000001000001
10000011000001000001
11111111111111000011
1000001      100001
1000001      100001
1000001      100001
1000001      100001
1000001      100001
1000001111111100001
10000000000000000001
1000N011000001000001
10000011000001000001
11111111111111111111