NO ./texture/north.xpm
SO ./texture/south.xpm
WE ./texture/west.xpm
EA ./texture/east.xpm
C 100,100,100
F 50,50,50
11111111111
10000000001
10000000001
10000E0001
10000000001
10000000001
11111111111
