NO ./texture/north.xpm
SO ./texture/south.xpm
WE ./texture/west.xpm
EA ./texture/east.xpm
C 100,100,100
F 50,50,50
11111111
10001001
10000001
10000S01
11111111
10001001
10000001
10000001
11111111
